NO textures/walls/orangeWall.xpm
SO textures/walls/grayWall.xpm
EA textures/walls/greenWall.xpm
WE textures/walls/redWall.xpm

F         0,0,0
C         121,190,219


 1111111        111111111
110000011      10000000001
100000001     1000000000001
 1000001     100000000000001
  11011      1000000000000001
   101        1000000100000001
   101         100001 100000001
   101111111111100000100000001
   10000000000000000000000001
   101111111111100000B000001
   101         100001000001
   101        100000000001
  11011      100000000001
 1000001     1000000E0001
100000001     10000000001
110000011      1000000001
 1111111        111111111
