NO ./textures/morocan/morocan_zlij_with_thinks.xpm
SO ./textures/morocan/morocan_zlij_with_thinks.xpm
EA ./textures/morocan/morocan_zlij.xpm
WE ./textures/morocan/morocan_zlij.xpm

F         160,82,45
C         135, 206, 235
 
1111111111111111111111111
1111111111111111111111111
1100000000000000000000011
1100000000000000000000011
1100000000000000N00000011
1100000000000000000000011
1111111111111111111111111
1111111111111111111111111
1111111111111111111111111
   
