NO textures/xpm/chessWall.xpm
SO textures/xpm/chessWall.xpm
EA textures/xpm/chessWall2.xpm
WE textures/xpm/chessWall2.xpm

F         128,82,45
C         135, 206, 235

11111111111111111111111111111111111
10000000010000000000000000000000001
10000000010000000000001000000000001
11000000000100000001001000000000001
10000000010000000N00001000000000001
10000000010000000000001000000000001
10000000010000000000001000000000001
10000000010000000000000000000000001
11111111111111111111111111111111111