NO ./textures/morocan/morocan_zlij_with_thinks.xpm
SO ./textures/morocan/morocan_zlij_with_thinks.xpm
EA ./textures/morocan/morocan_zlij.xpm
WE ./textures/morocan/morocan_zlij.xpm

F         160,82,45
C         135, 206, 235

11111111111111111
10000000000000001
10000000000000001
10000000000000001
10001000S000010001
10000000000000001
10000000000000001
11111111111111111