WE     textures/wolfenstein/grey_stone.xpm
NO      textures/wolfenstein/purple_stone.xpm



SO textures/wolfenstein/red_brick.xpm

F      17,    38,     64

EA textures/wolfenstein/wood.xpm





















C 218, 234, 235

   
1111111111111111111111  111111111111111
1000000000000000000001 1100000000000011
1111111111111111111111111111111111111111
 
111111111111111111111111111111111111111
100000000000000000000111100000000000011
100000000000000S0000000000100000000000011
100000000000000000000111100000000000011
1000000000000000000001 111111111111111
1111111111111111111111 111111111111111